###############
#.@@..@.@.....#
#.#@#.#.#.#.#.#
#..@...@......#
#.#.#@#.#.#.#.#
#..@@...@...@.#
#.#.#@#@#@#@#.#
#.@....@....@.#
#@#@#.#.#.#.#.#
#.@@..........#
###############