###############
#.@@h..@h.@s.....#
#.#@s#.#.#.#.#.#
#..@k...@h......#
#.#.#@#.#.#.#.#
#...@.3..@b...@.#
#@i#@#@b#@k#@#@#.#
#...........@.#
#@h#@b#.#.#.#.#.d#
#.@@..2.......1.#
###############