###############
#.@s...........#
#.#@#.#.#@#@#.#
#...@..@......#
#.#.#@#@h#.#.#.#
#..@@@........#
#.#.#@#.#.#.#.#
#@.@.@.@h..@...#
#@s#@#.#@#@#@i#@#
#.@b....@@@.@@@#
###############
