###############
#......@s...2..#
#.#@#.#.#@#@#.#
#...@..@..1...#
#.#.#@k#@h#.#.#.#
#..@@@.....3..#
#.#.#@#.#.#.#.#
#@.@.@h.@h..@...d#
#@s#@#.#@#@#@i#@#
#.@b.3..@@..@@@#
###############